{
  "width": 10,
  "height": 10,
  "tiles": [
    ["W","W","W","W","W","W","W","W","W","W"],
    ["W","P","E","E","W","E","E","E","G","W"],
    ["W","E","W","E","W","E","W","W","E","W"],
    ["W","E","W","E","E","E","E","W","E","W"],
    ["W","E","W","W","W","W","E","W","E","W"],
    ["W","E","E","E","E","W","E","E","E","W"],
    ["W","W","W","W","E","W","W","W","E","W"],
    ["W","E","E","W","E","E","E","W","E","W"],
    ["W","G","E","E","E","W","E","E","P","W"],
    ["W","W","W","W","W","W","W","W","W","W"]
  ]
}